93BBB9553B
AC6A84556A
AF96AFFF92
AFC5057FEA
AFFFAFFFBA
A97FAFD52A
A83FAFFFAA
C2C5453D2A
9691554542
C56C555556

0,0
9,9
SSSSSSSENESEEEESEEES